0,0,0,0,0,0,0,0
0,4,1,1,1,2,1,0
0,1,6,7,3,1,1,0
0,1,1,1,6,7,1,0
0,2,1,1,3,1,5,0
0,0,0,0,0,0,0,0
