0,0,0,0,0,0,0,0
0,2,4,1,1,5,1,0
0,2,1,7,3,3,1,0
0,0,1,6,1,1,1,0
0,0,1,1,1,1,1,0
0,0,0,0,0,0,0,0