0,0,0,0,0,0,0,0
0,0,0,1,1,1,1,0
0,0,0,4,1,6,1,0
0,0,2,1,1,7,1,0
0,0,0,2,1,1,0,0
0,0,0,0,1,3,1,0
0,1,5,1,3,1,1,0
0,1,1,1,0,1,1,0
0,0,0,0,0,0,0,0