0,0,0,0,0,0,0,0
0,1,1,1,1,1,1,0
0,2,7,3,3,7,2,0
0,1,6,1,1,6,1,0
0,1,1,4,1,5,1,0
0,0,0,0,0,0,0,0