0,0,0,0,0,0,0,0
0,0,1,1,2,1,0,0
0,0,4,0,1,3,0,0
0,0,1,1,3,2,0,0
0,0,1,6,7,1,0,0
0,0,5,1,1,1,0,0
0,0,0,0,0,0,0,0
