0,0,0,0,0,0,0,0
0,0,0,0,0,0,0,0
0,0,1,5,1,1,0,0
0,0,2,0,0,3,1,0
0,1,2,1,3,1,1,0
0,1,1,6,7,1,1,0
0,1,1,4,1,0,0,0
0,0,0,0,0,0,0,0
