0,0,0,0,0,0
0,0,4,2,0,0
0,2,1,1,0,0
0,1,3,1,1,0
0,1,7,6,1,0
0,1,1,3,1,0
0,5,1,1,1,0
0,0,0,0,0,0