0,0,0,0,0,0,0,0
0,0,0,0,0,1,1,0
0,0,0,0,0,1,2,0
0,4,5,1,0,3,1,0
0,1,7,1,1,1,3,0
0,1,6,1,1,1,2,0
0,1,1,1,1,1,1,0
0,0,0,0,0,0,0,0
