0,0,0,0,0,0,0,0
0,0,4,1,1,5,1,0
0,2,1,3,3,1,1,0
0,2,1,1,0,1,1,0
0,0,0,0,0,0,0,0