0,0,0,0,0,0
0,0,2,2,0,0
0,1,1,3,1,0
0,5,1,3,4,0
0,1,6,7,1,0
0,1,1,1,1,0
0,0,0,0,0,0