0,0,0,0,0,0,0,0
0,0,1,5,0,0,0,0
0,2,4,1,1,3,1,0
0,2,1,7,6,3,1,0
0,0,1,1,1,1,1,0
0,0,0,0,0,0,0,0