0,0,0,0,0,0,0,0,0
0,1,1,1,7,1,2,4,0
0,1,5,1,6,1,1,1,0
0,1,3,1,1,1,1,1,0
0,7,6,3,1,6,1,1,0
0,1,1,1,1,7,1,2,0
0,0,0,0,0,0,0,0,0
