0,0,0,0,0,0,0,0,0
0,1,1,1,1,2,1,4,0
0,1,5,1,3,1,1,1,0
0,1,1,1,6,7,1,1,0
0,2,3,1,1,1,1,1,0
0,1,1,1,1,1,1,1,0
0,0,0,0,0,0,0,0,0
