0,0,0,0,0,0
0,4,1,1,2,0
0,1,5,6,7,0
0,1,3,1,1,0
0,2,1,3,1,0
0,0,0,0,0,0
