0,0,0,0,0,0,0,0
0,0,1,1,1,1,1,0
0,0,7,6,1,3,1,0
0,1,3,4,5,2,0,0
0,1,1,2,1,1,0,0
0,0,0,0,0,0,0,0