0,0,0,0,0,0,0,0,0,0,0,0,0,0,0,0,0
0,0,1,4,0,1,1,1,1,1,1,1,0,1,1,1,0
0,2,1,1,0,1,1,1,0,7,6,1,1,1,3,1,0
0,1,2,1,0,1,3,1,1,1,1,1,1,0,1,1,0
0,0,1,0,0,1,7,1,0,0,0,1,1,1,5,1,0
0,0,1,0,0,1,6,1,1,1,1,1,0,1,1,1,0
0,0,1,1,1,1,1,1,0,1,6,1,1,7,6,1,0
0,0,1,1,0,1,1,1,1,1,7,1,0,1,1,1,0
0,0,0,0,0,0,0,0,0,0,0,0,0,0,0,0,0