0,0,0,0,0,0,0
0,1,2,1,2,1,0
0,1,3,6,7,1,0
0,1,3,1,1,1,0
0,0,4,1,5,0,0
0,0,0,0,0,0,0