0,0,0,0,0,0,0,0
0,0,0,1,1,0,0,0
0,0,1,5,1,1,0,0
0,1,2,1,2,3,0,0
0,1,1,3,4,1,1,0
0,0,0,1,7,6,1,0
0,0,0,1,1,1,1,0
0,0,0,0,0,0,0,0
