0,0,0,0,0,0,0,0
0,4,5,0,0,0,0,0
0,1,1,3,1,3,1,0
0,1,1,2,2,1,1,0
0,0,0,0,0,0,0,0