0,0,0,0,0,0,0,0
0,0,1,1,1,1,1,0
0,0,1,6,7,3,1,0
0,1,3,4,5,2,1,0
0,1,1,2,1,1,0,0
0,0,0,0,0,0,0,0